odg|application/vnd.oasis.opendocument.graphics
otg|application/vnd.oasis.opendocument.graphics-template
fodg|text/xml
sxd|application/vnd.sun.xml.draw
std|application/vnd.sun.xml.draw.template
wpg|application/wpg
dxf|image/vnd.dxf
emf|application/emf
eps| application/eps
met|application/octet-stream
pct|image/x-pict
pict|image/pict
sgf|image/x-sgf
sgv|image/x-sgv
svm|image/x-svm
wmf|application/wmf
bmp|image/bmp
cwk|application/clarisworks
cdr|application/coreldraw
cmx|application/cmx
fh|image/x-freehand
fh1|image/x-freehand
fh2|image/x-freehand
fh3|image/x-freehand
fh4|image/x-freehand
fh5|image/x-freehand
fh6|image/x-freehand
fh7|image/x-freehand
fh8|image/x-freehand
fh9|image/x-freehand
fh10|image/x-freehand
fh11|image/x-freehand
gif| image/gif
jpg|image/jpeg
jpeg|image/jpeg
mov|image/mov
pbm|image/x-portable-bitmap
pcx|application/pcx
pgm|image/x-portable-graymap
png|image/png
ppm|application/ppm
psd|image/photoshop
pub|application/x-mspublisher
ras|application/ras
svg|image/svg
svgz|image/svg
tga|application/tga
tif|image/tif
tiff|image/tiff
vdx|application/visio
vsd|application/visio
vsdm|application/visio
vsdx|application/visio
xbm|image/x-xbitmap
xpm|image/xpm
pcd|image/x-photo-cd
pdf|application/pdf